  ##############
#              #
#      P       #
#   X          #
#      O       #
#              #
#              #
#              #
### ############
