########
#      ##
#      P##
#        ##
#      O  ######
#              #
#  X           #
#              #
#        #######
####    ##
   #    #
   #    #
   ######
