##########
#       0#
#        #
#P      X#
#        #
##########
