##############
#  P  X  O   #
#            #
#  l         #
##############
