################
#              #
#              #
#  P    O   O  #
#        X     #
################
